7 0 0 0 1 5 1 0 0 0 0 0 8
0 1 3 2 1 4 1 1 1 0 1 6 1
5 1 1 1 1 2 1 2 1 1 1 3 1
1 2 2 2 1 5 1 3 1 2 1 1 1
1 2 1 1 1 2 1 2 1 1 2 2 5 
1 1 1 2 1 3 1 5 1 2 1 2 1
1 3 6 1 1 2 1 2 1 1 3 1 0
0 1 0 0 0 1 1 4 1 2 0 7 0
8 1 0 0 0 0 1 5 0 0 0 0 0
